1111111111111111111111111111111111111111111111111111111111111111111111111111111111111111111111111111
1000000000000000000000000000000000000000000000000000000000000000000000000000000000000000000000000001
1000000000000000000000000000000000000000000000000000000000000000000000000000000000000000000000000001
1000000000000000000000000000000000000000000000000000000000000000000000000000000000000000000000000001
1000000000000000000000000000000000000000000000000000000000000000000000000000000000000000000000000001
1000000000000000000000000000000000000000000000000000000000000000000000000000000000000000000000000001
1000000000000000000000000000000000000000000000000000000000000000000000000000000000000000000000000001
1000000000000000000000000000000000000000000000000000000000000000000000000000000000000000000000000001
1000000000000000000000000000000000000000000000000000000000000000000000000000000000000000000000000001
1000000000000000000000000000000000000000000000000000000000000000000000000000000000000000000000000001
1000000000000000000000000000000000000000000000000000000000000000000000000000000000000000000000000001
1000000000000000000000000000000000000000000000000000000000000000000000000000000000000000000000000001
1002222222222222222200000000000000000000000000000000000000000000000000000000000000000000000000000001
1002222222222222222200000000000000000000000000000000000000000000000000000000000000000000000000000001
1002222222222222222200000000000000000000000000000000000000000000000000000000000000000000000000000001
1002222222222222222200000000000000000000000000000000000000000000000000000000000000000000000000000001
1002222222222222222200000000000000000000000000000000000000000000000000000000000000000000000000000001
1002222222222222222200000000000000000000000000000000000000000000000000000000000000000000000000000001
1002222222222222222200000000000000000000000000000000000000000000000000000000000000000000000000000001
1002222222222222222200000000000000000000000000000000000000000000000000000000000000000000000000000001
1002222222222222222200000000000000000000000000000000000000000000000000000000000000000000000000000001
1002222222222222222200000000000000000000000000000000000000000000000000000000000000000000000000000001
1002222222222222222200000000000000000000000000000000000000000000000000000000000000000000000000000001
1002222222222222222200000000000000000000000000000000000000000000000000000000000000000000000000000001
1002222222222222222200000000000000000000000002222222222222222222220000000000000000000000000000000001
1002222222222222222200000000000000000000000002222222222222222222220000000000000000000000000000000001
1002222222222222222200000000000000000000000002222222222222222222220000000000000000000000000000000001
1002222222222222222200000000000000000000000002222222222222222222220000000000000000000000000000000001
1002222222222222222200000000000000000000000002222222222222222222220000000000000000000000000000000001
1002222222222222222200000000000000000000000002222222222222222222220000000000000000000000000000000001
1002222222222222222200000000000000000000000002222222222222222222220000000000000000000000000000000001
1002222222222222222200000000000000000000000002222222222222222222220000000000000000000000000000000001
1002222222222222222200000000000000000000000002222222222222222222220000000000000000000000000000000001
1002222222222222222200000000000000000000000002222222222222222222220000000000000000000000000000000001
1002222222222222222200000000000000000000000000000000000000000000000000000000000000000000000000000001
1002222222222222222200000000000000000000000000000000000000000000000000000000000000000000000000000001
1000000000000000000000000000000000000000000000000000000000000000000000000000000000000000000000000001
1000000000000000000000000000000000000000000000000000000000000000000000000000000000000000000000000001
1000000000000000000000000000000000000000000000000000000000000000000000000000000000000000000000000001
1000000000000000000000000000000000000000000000000000000000000000000000000000000000000000000000000001
1000000000000000000022222222222222000000000000000000000000000000000000000000000000000000000000000001
1000000000000000000022222222222222000000000000000000000000000000000000000000000000000000000000000001
1000000000000000000022222222222222000000000000000000000000000000000000000000000000000000000000000001
1000000000000000000022222222222222000000000000000000000000000000000000000000000000000000000000000001
1000000000000000000022222222222222000000000000000000000000000000000000000000000000000000000000000001
1000000000000000000022222222222222000000000000000000000000002222220000000000000000000000000000000001
1000000000000000000022222222222222000000000000000000000000002222220000000000000000000000000000000001
1000000000000000000022222222222222000000000000000000000000002222220000000000000000000000000000000001
1000000000000000000022222222222222000000000000000000000000002222220000000000000000000000000000000001
1000000000000000000022222222222222000000000000000000000000002222220000000000000000000000000000000001
1000000000000000000022222222222222000000000000000000000000002222220000000000000000000000000000000001
1000000000000000000022222222222222000000000000000000000000002222220000000000000000000000000000000001
1000000000000000000022222222222222000000000000000000000000002222220000000000000000000000000000000001
1000000000000000000000000000000000000000000000000000000000002222220000000000000000000000000000000001
1000002222222200000000000000000000000000000000000000000000002222220000000000000000000000000000000001
1000002222222200000000000000000000000000000000000000000000002222220000000000000000000000000000000001
1000002222222200000000000000000000000000000000000000000000002222220000000000000000000000000000000001
1000002222222200000000000000000000000000000000000000000000002222220000000000000000000000000000000001
1000002222222200000000000000000000000000000000000000000000002222220000000000000000000000000000000001
1000002222222200000000000000000000000000000000000000000000002222220000000000000000000000000000000001
1000002222222200000000000000000000222222222222222222220000002222220000000000000000000000000000000001
1000002222222200000000000000000000222222222222222222220000002222220000000000000000000000000000000001
1000002222222200000000000000000000222222222222222222220000002222220000000000000000000000000000002221
1000002222222200000000000000000000222222222222222222220000000000000000000000000000000000000000002221
1000002222222200000000000000000000222222222222222222220000000000000000000000000000000000000000002221
1000002222222200000000000000000000222222222222222222220000000000000000000000000000000000000000002221
1000002222222200000000000000000000222222222222222222220000000000000000000000000000000000000000002221
1000002222222200000000000000000000222222222222222222220000000000000000000000000000000000000000002221
1000002222222200000000000000000000222222222222222222220000000000000000000000000000000000000000002221
1000002222222200000000000000000000222222222222222222220000000000000000000000000000000000000000002221
1000002222222200000000000000000000222222222222222222220000000000000000000000000000000000000000002221
1000002222222200000000000000000000222222222222222222220000000000000000000000000000000000000000002221
1000002222222200000000000000000000222222222222222222220000000000000000000000000000000000000000002221
1000000000000000000000000000000000222222222222222222220000000000000000000000000000000000000000002221
1000000000000000000000000000000000222222222222222222220000000000000000000000000000000000000000002221
1000000000000000000000000000000000222222222222222222220000000000000000000000000000000000000000002221
1000000000000000000000000000000000222222222222222222220000000000000000000000000000000000000000002221
1000000000000000000000000000000000222222222222222222220000000000000000000000000000000000000000002221
1000000000000000000000000000000000222222222222222222220000000000000000000000000000000000000000002221
1000000000000000000000000000000000222222222222222222220000000000000000000000000000000000000000002221
1000000000000000000000000000000000222222222222222222220000000000000000000000000000000000000000002221
1000000000000000000000000000000000222222222222222222220000000000000000000000000000000000000000002221
1000000000000000000000000000000000222222222222222222220000000000000000000000000000000000000000002221
1000000000000000000000000000000000222222222222222222220000000000000000000000000000000000000000000001
1000000000000000000000000000000000222222222222222222220000000000000000000000000000000000000000000001
1000000000000000000000000000000000000000000000000000000000000000000000000000000000000000000000000001
1000000000000000000000000000000000000000000000000000000000000000000000000000000000000000000000000001
1000000000000000000000000000000000000000000000000000000000000000000000000000000000000000000000000001
1000000000000000000000000000000000000000000000000000000000000000000000000000000000000000000000000001
1000000000000000000000000000000000000000000000000000000000000000000000000000000000000000000000000001
1000000000000000000000000000000000000000000000000000000002222222222222200000000000000000000000000001
1000000000000000000000000000000000000000000000000000000002222222222222200000000000000000000000000001
1000000000000000000000000000000000000000000000000000000002222222222222200000000000000000000000000001
1000000000000000000000000000000000000000000000000000000002222222222222200000000000000000000000000001
1000000000000000000000000000000000000000000002222222222222222222222222200000000000000000000000000001
1000000000000000000000000000000000000000000022222222222222222222222222200000000000000000000000000001
1000000000000000000000000000000000000000000022222222222222222222222222200000000000000000000000000001
1000000000000000000000000000000000000000000022200000000002222222222222200000000000000000000000000001
1000000000000000000000000000000000000000000022200000000002222222222222200000000000000000000000000001
1111111111111111111111111111111111111111111222221111111111111111111111111111111111111111111111111111
