1111111111111111111111111111111111111111111111111111111111111111111111111111111111111111111111111111
1000000000000000000000000000000000000000000000000000000000000000000000000000000000000000000000000001
1000000000000000000000000000000000000000000000000000000000000000000000000000000000000000000000000001
1000000000000000000000000000000000000000000000000000000000000000000000000000000000000000000000000001
1000000000000000000000000000000000000000000000000000000000000000000000000000000000000000000000000001
1000000000000000000000000000000000000000000000000000000000000000000000000000000000000000000000000001
1000000000000000000000000000000000000000000000000000000000000000000000000000000000000000000000000001
1000000000000000000000000000000000000000000000000000000000000000000000000000000000000000000000000001
1000000000000000000000000000000000000000000000000000000000000000000000000000000000000000000000000001
1000000000000000000000000000000000000000000000000000000000000000000000000000000000000000000000000001
1000000000000000000000000000000000000000000000000000000000000000000000000000000000000000000000000001
1000000000000000000000000000000000000000000000000000000000000000000000000000000000000000000000000001
1000000000000000000000002222222222222222000000000000000000000000000000000000000000000000000000000001
1000000000000000000000002222222222222222000000000000000000000000000000000000000000000000000000000001
1000000000000000000000002222222222222222000000000000000000000000000000000000000000000000000000000001
1000000000000000000000002222222222222222000000000000000000000000000000000000000000000000000000000001
1000000000000000000000002222222222222222000000000000000000000000000000000000000000000000000000000001
1000000000000000000000002222222222222222000000000000000000000000000000000000000000000000000000000001
1000000000000000000000002222222222222222000000000000000000000000000000000000000000000000000000000001
1000000000000000000000002222222222222222000000000000000000000000000000000000000000000000000000000001
1000000000000000000000002222222222222222000000000000000000000000000000000000000000000000000000000001
1000000000000000000000002222222222222222000000000000000000222222222222222222222222222000000000000001
1000000000000000000000002222222222222222000000000000000000222222222222222222222222222000222222222001
1000000000000000000000002222222222222222000000000000000000222000000000000000000000222002222222222201
1000000000000000000000002222222222222222000000000000000000222002222222220000000000222002222222222201
1000000000000000000000002222222222222222000000000000000000222022222222222000000000222002220000022201
1000000000000000000000002222222222222222000000000000000000222022222222222022222222222222222220022201
1000000000000000000000002222222222222222000000000000000000222022200000222022222222222222222220022201
1000000000000000000000002222222222222222000000000002222222222222222000222022222222222222222220022201
1000000000000000000000002222222222222222000000000002222222222222222000222022222222222222222220222221
1000000000000000000000002222222222222222000000000002222222222222222000222022222222222222222220222221
1000000000000000000000002222222222222222000000000002222222222222222000222022222222222222222220222221
1000000000000000000000002222222222222222000000000002222222222222222000222022222222222222222220222221
1000000000000000000000002222222222222222000000000002222222222222222000222022222222222222222220222221
1000000000000000000000002222222222222222000000000002222222222222222000222022222222222222222220222221
1000000000000000000000002222222222222222000000000002222222222222222000222022222222222222222220222221
1000000000000000000000002222222222222222000000000002222222222222222000222022222222222222222220222221
1000000000000000000000000002220022200000000000000002222222222222222000222022222222222222222220222221
1000000000000000000000022222220022200000000000000002222222222222222000222022222222222222222220222221
1000000000000000000000222222220222200000000000000002222222222222222000222022222222222222222220222221
1000000000000000000000222222200222000000000000000002222222222222222000222022222222222222222220222221
1000000000000000000000222000000222000000000000000002222222222222222000222022222222222222222220222221
1000000000000000000000222000000222000000000000000002222222222222222000222022222222222222222220222221
1000000000000000000000222000000222000000000000000002222222222222222000222022222222222222222220222221
1000000000000000000000222000000222000000000000000002222222222222222000222022222222222222222220222221
1000000000000000000000222000000222000000000000000002222222222222222000222022222222222222222220222221
1000000000000000000000222000000222000000000000000002222222222222222000222022222222222222222220222221
1000000000000000000000222000000222000000000000000002222222222222222000222022222222222222222220222221
1002222222222222220000222000000222000000000000000002222222222222222000222222222222222222222220222221
1022222222222222222000222000000222000000000000000000000000000000000000222220000000000022200000222221
1022222222222222222000222000000222000000000000000000000000000000000000022220000000000022200000222221
1022200000000000222000222000000222000000000000022222222222222222222222202220000000000022220000000001
1022200222222200222000222000000222000000000000022222222222222222222222202220000000000002220000000001
1022202222222220222000222000000222000000000000022222222222222222222222202220000000000002220000000001
1022202222222220222000222000000222000000000000022222222222222222222222202220000000000002220000000001
1022202220002220222000222000000222000000000000022222222222222222222222202220000000000002220000000001
1022202220222222222222222222220222000000000000022222222222222222222222202220000000000002220000000001
1022202220222222222222222222220222000000000000022222222222222222222222202220000000000002220000000001
1022202220222222222222222222220222000000000000022222222222222222222222202220000222222222222222200001
1022202220222222222222222222220222000000000000022222222222222222222222202220000222222222222222200001
1022202220222222222222222222220222000000000000022222222222222222222222202220000222222222222222200001
1022202220222222222222222222220222000000000000022222222222222222222222202220000222222222222222200001
1022202220222222222222222222220222000000000000022222222222222222222222202220000222222222222222200001
1022202220222222222222222222220222000000000000022222222222222222222222202220000222222222222222200001
1022202220222222222222222222220222002222222222222222222222222222222222202220000222222222222222200001
1022202220222222222222222222220222022222222222222222222222222222222222202220000222222222222222200001
1022202220222222222222222222220222022222222222222222222222222222222222222220000222222222222222200001
1022202220222222222222222222220222022200000000022222222222222222222222222220000222222222222222200001
1022202220222222222222222222220222022200000000022222222222222222222222222200000222222222222222200001
1022202220222222222222222222220222022200000000022222222222222222222222200000000222222222222222200001
1022202220222222222222222222220222022200000000022222222222222222222222200000000222222222222222200001
1022202220222222222222222222220222022200000000022222222222222222222222200000000222222222222222200001
1022202220222222222222222222220222022200000000022222222222222222222222200000000222222222222222200001
1022202220222222222222222222220222022200000000022222222222222222222222200000000222222222222222200001
1022202220222222222222222222220222022200000000022222222222222222222222200000000222222222222222200001
1022202222222222222222222222222222022200000000000000002220000000000000000000000222222222222222200001
1022222222200000000000000000022222222200000000022222222220000000000000000000000222222222222222200001
1022222222222222222222222222222222222200000000222222222220000000000000000000000222222222222222200001
1002222022222222222222222222222202222000000000222222222200000000000000000000000000222000000000000001
1000222202222222222222222222222022220000000000222000000000000000000000000000000000222222222222200001
1000022220000000000000000000000222200000000000222000000000000000000000000000000000222222222222220001
1000002222222222222222222222222222000000000000222000000000000000000000000000000000022222222222220001
1000000222222222222222222222222220000000000000222000000000000000000000000000000000000000000002220001
1000000022222222222222222222222200000000000000222000000000000000000000000000000000000000000002220001
1000000000000000000000000000000000000000000000222000000000000000000000000000000000000000000002220001
1000000000000000000000000000000000000000000000222000000000000000000000000000000000000000000002220001
1000000000000000000000000000000000000000000000222000000000000000000000000000000000000000000002220001
1000000000000000000000000000000000000000000000222000000000000000000000000000000000000000000002220001
1000000000000000000000000000000000000000000000222000000000000000000000000000000000000000000002220001
1000000000000000000000000000000000000000000000222000000000000000000000000000000000000000000002220001
1000000000000000000000000000000000000000000000222000000000000000000000000000000000000000000002220001
1000000000000000000000000000000000000000000000222000000000000000000000000000000000022222222222222221
1000000000000000000000000000000000000000000000222000000000000000000000000000000000022222222222222221
1000000000000000000000000000000000000000000000222000000000000000000000000000000000022222222222222221
1000000000000000000000000000000000000000000000222000000000000000000000000000000000022222222222222221
1000000000000000000000000000000000000000000000222000000000000000000000000000000000022222222222222221
1000000000000000000000000000000000000000000000222000000000000000000000000000000000022222222222222221
1000000000000000000000000000000000000000000000222000000000000000000000000000000000022222222222222221
1000000000000000000000000000000000000000000000222000000000000000000000000000000000022222222222222221
1111111111111111111111111111111111111111111112222211111111111111111111111111111111111111111111111111
