1111111111111111111111111111111111111111111111111111111111111111111111111111111111111111111111111111
1000000000000000000000000000000000000000000000000000000000000000000000000000000000000000000000000001
1000000000000000000000000000000000000000000000000000000000000000000000000000000000000000000000000001
1000000000000000000000000000000000000000000000000000000000000000000000000000000000000000000000000001
1000000000000000000000000000000000000000000000000000000000000000000000000000000000000000000000000001
1000000000000000000000000000000000000000000000000000000000000000000000000000000000000000000000000001
1000000000000000000000000000000000000000000000000000000000000000000000000000000000000000000000000001
1000000000000000000000000000000000000000000000000000000000000000000000000000000000000000000000000001
1000000000000000000000000000000000000000000000000000000000000000000000000000000000000000000000000001
1000000000000000000000000000000000000000000000000000000000000000000000000000000000000000000000000001
1000000000000000000000000000000000000000000000000000000000000000000000000000000000000000000000000001
1000000000000000000000000000000000000000000000000000000000000000000000000000000000000000000000000001
1002222222222222222200000000000000000000000000000000000000000000000000000000000000000000000000000001
1002222222222222222200000000000000000000000000000000000000000000000000000000000000000000000000000001
1002222222222222222200000000000000000000000000000000000000000000000000000000000000000000000000000001
1002222222222222222200000000000000000000000000000000000000000000000000000000000000000000000000000001
1002222222222222222200000000000000000000000000000000000000000000000000000000000000000000000000000001
1002222222222222222200000000000000000000000000000000000000000000000000000000000000000000000000000001
1002222222222222222200000000000000000000000000000000000000000000000000000000000000000000000000000001
1002222222222222222200000000000000000000000000000000000000000000000000000000000000000000000000000001
1002222222222222222200000000000000000000000000000000000000000000000000000000000000000000000000000001
1002222222222222222200000000000000000000000000000000000000000000000000000000000000000000000000000001
1002222222222222222200000000000000000000000000000000000000000000000000000000000000000000000000000001
1002222222222222222200000000000000000000000000000000000000000000000000000000000000000000000000000001
1002222222222222222200000000000000000000000002222222222222222222220000000000000000000000000000000001
1002222222222222222200000000000000000000000002222222222222222222220000000000000000000000000000000001
1002222222222222222200000000000000000000000002222222222222222222220000000000000000000000000000000001
1002222222222222222200000000000000000000000002222222222222222222220000000000000000000000000000000001
1002222222222222222200000000000000000000000002222222222222222222220000000000000000000000000000000001
1002222222222222222200000000000000000000000002222222222222222222220000000000000000000000000000000001
1002222222222222222200000000000000000000000002222222222222222222220000000000000000000000000000000001
1002222222222222222200000000000000000000000002222222222222222222220000000000000000000000000000000001
1002222222222222222200000000000000000000000002222222222222222222220000000000000000000000000000000001
1002222222222222222200000000000000000000000002222222222222222222220000000000000000000000000000000001
1002222222222222222200000000000000000000000000000000000000000000000000000000000000000000000000000001
1002222222222222222200000000000000000000000000000000000000000000000000000000000000000000000000000001
1000000000000000000000000000000000000000000000000000000000000000000000000000000000000000000000000001
1000000000000000000000000000000000000000000000000000000000000000000000000000000000000000000000000001
1000000000000000000000000000000000000000000000000000000000000000000000000000000000000000000000000001
1000000000000000000000000000000000000000000000000000000000000000000000000000000000000000000000000001
1000000000000000000022222222222222000000000000000000000000000000000000000000000000000000000000000001
1000000000000000000022222222222222000000000000000000000000000000000000000000000000000000000000000001
1000000000000000000022222222222222000000000000000000000000000000000000000000000000000000000000000001
1000000000000000000022222222222222000000000000000000000000000000000000000000000000000000000000000001
1000000000000000000022222222222222000000000000000000000000000000000000000000000000000000000000000001
1000000000000000000022222222222222000000000000000000000000002222220000000000000000000000000000000001
1000000000000000000022222222222222000000000000000000000000002222220000000000000000000000000000000001
1000000000000000000022222222222222000000000000000000000000002222220000000000000000000000000000000001
1000000000000000000022222222222222000000000000000000000000002222220000000000000000000000000000000001
1000000000000000000022222222222222000000000000000000000000002222220000000000000000000000000000000001
1000000000000000000022222222222222000000000000000000000000002222220000000000000000000000000000000001
1000000000000000000022222222222222000000000000000000000000002222220000000000000000000000000000000001
1000000000000000000022222222222222000000000000000000000000002222220000000000000000000000000000000001
1000000000000000000000000000000000000000000000000000000000002222220000000000000000000000000000000001
1000002222222200000000000000000000000000000000000000000000002222220000000000000000000000000000000001
1000002222222200000000000000000000000000000000000000000000002222220000000000000000000000000000000001
1000002222222200000000000000000000000000000000000000000000002222220000000000000000000000000000000001
1000002222222200000000000000000000000000000000000000000000002222220000000000000000000000000000000001
1000002222222200000000000000000000000000000000000000000000002222220000000000000000000000000000000001
1000002222222200000000000000000000000000000000000000000000002222220000000000000000000000000000000001
1000002222222200000000000000000000222222222222222222220000002222220000000000000000000000000000000001
1000002222222200000000000000000000222222222222222222220000002222220000000000000000000000000000000001
1000002222222200000000000000000000222222222222222222220000002222220000000000000000000000000000002221
1000002222222200000000000000000000222222222222222222220000000000000000000000000000000000000000002221
1000002222222200000000000000000000222222222222222222220000000000000000000000000000000000000000002221
1000002222222200000000000000000000222222222222222222220000000000000000000000000000000000000000002221
1000002222222200000000000000000000222222222222222222220000000000000000000000000000000000000000002221
1000002222222200000000000000000000222222222222222222220000000000000000000000000000000000000000002221
1000002222222200000000000000000000222222222222222222220000000000000000000000000000000000000000002221
1000002222222200000000000000000000222222222222222222220000000000000000000000000000000000000000002221
1000002222222200000000000000000000222222222222222222220000000000000000000000000000000000000000002221
1000002222222200000000000000000000222222222222222222220000000000000000000000000000000000000000002221
1000002222222200000000000000000000222222222222222222220000000000000000000000000000000000000000002221
1000000000000000000000000000000000222222222222222222220000000000000000000000000000000000000000002221
1000000000000000000000000000000000222222222222222222220000000000000000000000000000000000000000002221
1000000000000000000000000000000000222222222222222222220000000000000000000000000000000000000000002221
1000000000000000000000000000000000222222222222222222220000000000000000000000000000000000000000002221
1000000000000000000000000000000000222222222222222222220000000000000000000000000000000000000000002221
1000000000000000000000000000000000222222222222222222220000000000000000000000000000000000000000002221
1000000000000000000000000000000000222222222222222222220000000000000000000000000000000000000000002221
1000000000000000000000000000000000222222222222222222220000000000000000000000000000000000000000002221
1000000000000000000000000000000000222222222222222222220000000000000000000000000000000000000000002221
1000000000000000000000000000000000222222222222222222220000000000000000000000000000000000000000002221
1000000000000000000000000000000000222222222222222222220000000000000000000000000000000000000000000001
1000000000000000000000000000000000222222222222222222220000000000000000000000000000000000000000000001
1000000000000000000000000000000000000000000000000000000000000000000000000000000000000000000000000001
1000000000000000000000000000000000000000000000000000000000000000000000000000000000000000000000000001
1000000000000000000000000000000000000000000000000000000000000000000000000000000000000000000000000001
1000000000000000000000000000000000000000000000000000000000000000000000000000000000000000000000000001
1000000000000000000000000000000000000000000000000000000000000000000000000000000000000000000000000001
100000000000000000000000000000000000000000000000000000000;:::::::::::::00000000000000000000000000001
100000000000000000000000000000000000000000000000000000000;:::::::::::::00000000000000000000000000001
100000000000000000000000000000000000000000000000000000000;:::::::::::::00000000000000000000000000001
100000000000000000000000000000000000000000000000000077777;:::::::::::::00000000000000000000000000001
1000000000000000000000000000000000000000000777770000777778:::::::::::::00000000000000000000000000001
1000000000000000000000000000000000000000000777770000777778:::::::::::::00000000000000000000000000001
1000000000000000000000000000000000000000000777770000777778:::::::::::::00000000000000000000000000001
100000000000000000000000000000000000000000077777000077777;:::::::::::::00000000000000000000000000001
100000000000000000000000000000000000000000077777000000000;:::::::::::::00000000000000000000000000001
1111111111111111111111111111111111111111111:888;1111111111111111111111111111111111111111111111111111
