1111111111111111111111111111111111111111111111111111111111111111111111111111111111111111111111111111
1111111111111111111111111111111111111111111111111111111111111111111111111111111111111111111111111111
1111111111111111111111111111111111111111111111111111111111111111111111111111111111111111111111111111
1111111111111111111111111111111111111111111111111111111111111111111111111111111111111111111111111111
1111111111111111111111111111111111111111111111111111111111111111111111111111111111111111111111111111
1111111111111111111122222222222222221111111111111111111111111111111111111111111111111111111111111111
1111111111111111111122222222222222221111111111111111111111111111111111111111111111111111111111111111
1111111111111222222222222222222222221111111111111111111111111111111111111111111111111111111111111111
1111111111112222222222222222222222222222211111111111111111111111111111111111111111111111111111111111
1111111111112222222222222222222222222222221111111111111111111111111111111111111111111111111111111111
1111111111112221111122222222222222222222221111111111111111111111111111111111111111111111111111111111
1111111111112221111122222222222222221112221111111111111111111111111111111111111111111111111111111111
1111111111112221111122222222222222221112221111111111111111111111111111111112222222222222222222222111
1111111111112221111122222222222222221112221111111111111111112222222222222222222222222222222222222211
1111111111112221111122222222222222221112221111111111111111112222222222222222222222222222222222222211
1111111111112221111122222222222222221112221111111111111111112222222222222221111111111111111111122211
1111111111112221111122222222222222221112221111111111111111112222222222222221111111111111111111122211
1111111111112221111122222222222222221112221111111111111111112222222222222221111111111111111111122211
1111111111112221111122222222222222221112221111111111111111112222222222222221111111111111111111122211
1111111111112221111111111111222111111112221111111111111111112222222222222221111111111111111111122211
1111111111112221111111111111222111111112221111111111111111112222222222222221111111111111111111122211
1111111111112221111111222222222111111112221111111111111111112222222222222222222222222222222211122211
1111111111112221111112222222222111111112221111111111111111112222222222222222222222222222222221122211
1111111111112221111112222222221111111112221111111111111111112222222222222222222222222222222221122211
1111111111112221111112221111111111111112221111111111111111112222222222222221111111111111112221122211
1111111111112221111112221111111111111112221111111111111111112222222222222221111111111111112221122211
1111111111112221111112221111111111111112221111111111111111111111111111111111111111111111112221122211
1111111111112221111112221111111111111112221111111111111111111111111111111111111111111111112221122211
1111111111112221111112221111111111111112221111111111111111111111111111111111111111111111112221122211
1111111111112221111112221111222222222112221111111111111111111111111111111111111111111111112221122211
1111111111112221111112221112222222222212221111111111111111111111111111111111111111111111112221122211
1111111111112221111112221112222222222212221111111111111111111111111111111111111111111111112221122211
1111111111112221111112221112221111122212221111111111111111111111111111111111111111111111112221122211
1111111111112221111112221112221111122212221111111111111111111111111111111111111111111111112221122211
1111111111112221122222222222222221122212221111111111111111111111111111111111111111111111112221122211
1111111111112221122222222222222221122212221111111111111111111111111111111111111111111111112221122211
1111111111112221122222222222222221122212221111111111111111111111111111111111111111111111112221122211
1111111111112221122222222222222221122212221111111111111111111111111111111111111111111111112222222211
1111111111112221122222222222222221122212221111111111111111111111111111111111111111111111112222222211
1111111111112221122222222222222221122212221111111111111111111111111111111111111111111111111222222211
1111111111112221122222222222222221122212221111111111111111111111111111111111111111111111111111122211
1111111111112221122222222222222221122212221111111111111111111111111111111111111111111111111111122211
1111111111112221122222222222222221122212221111111111111111111111111111111111111111111111111111122211
1111111111112221122222222222222221122212221111111111111111111111111111111111111111111111111111122211
1111111111112221122222222222222221122212221111111111111111111111111111111111111111111111111111111111
1111111111112221122222222222222221122212221111111111111111111111111111111111111111111111111111111111
1111111111112221122222222222222221122212221111111111111111111111111111111111111111111111111111111111
1111111111112221122222222222222221122212221111111111111111111111111111111111111111111111111111111111
1111111111112222111111111111111111222212221111111111111111111111111111111111111111111111111111111111
1111111111112222211111111111111112222222221111111111111111111111111111111111111111111111111111111111
1111111111111222222222222222222222222222221111111111111111111111111111111111111111111111111111111111
1111111111111122222222222222222222221222211111111111111111111111111111111111111111111111111111111111
1111111111111112222222222222222222212222111111111111111111111111111111111111111111111111111111111111
1111111111111111111111111111111111122221111111111111111111111111111111111111111111111111111111111111
1111111222222222222222222222222222222211111111111111111111111111111111111111111111111111111111111111
1111112222222222222222222222222222222111111111111111111111111111111111111111111111111111111111111111
1111112222222222222222222222222222221111111111111111111111111111111111111111111111111111111111111111
1111112221111111111111111111111111111111111111111111111111111111111111111111111111111111111111111111
1111112221111111111111111111111111111111111111111111111111111111111111111111111111111111111111111111
1111112221111111111111111111111111111111111111111111111111111111111111111111111111111111111111111111
1111112221111111111111111111111111111111111111111111111111111111111111111111111111111111111111111111
1111112221111111111111111111111111111111111111111111111111111111111111111111111111111111111111111111
1111112221111111111111111111111111111111111111111111111111111111111111111111111111111111111111111111
1111112221111111111111111111111111111111111111111111111111111111111111111111111111111111111111111111
1111112221111111111111111111111111111111111111111111111111111111111111111111111111111111111111111111
1111112222222221111111111111111111111111111111111111111111111111111111111111111111111111111111111111
1111112222222221111111111111111111111111111111111111111111111111111111111111111111111111111111111111
1111112222222221111111111111111111111111111111111111111111111111111111111111111111111111111111111111
1111112222222221111111111111111111111111111111111111111111111111111111111111111111111111111111111111
1111112222222221111111111111111111111111111111111111111111111111111111111111111111111111111111111111
1111112222222221111111111111111111222222222222222222222222222222211111111111111111111111111111111111
1111112222222221111111111111111112222222222222222222222222222222221111111111111111111111111111111111
1111112222222221111111111111111112222222222222222222222222222222221111111111111111111111111111111111
1111112222222221111111111111111112221111111111111111111111111112221111111111111111111111111111111111
1111112222222221111111111111111112221111111111111111111111111112221111111111111111111111111111111111
1111112222222221111111111111111112221111111111111111111222222222222222222111111111111111111111111111
1111112222222221111111111111111112221111111111111111111222222222222222222111111111111111111111111111
1111112222222221111111111111111112221111112222222222222222222222222222222111111111111111111111111111
1111112222222221111111111111111112221111122222222222222222222222222222222111111111111111111111111111
1111112222222221111111111111111112221111122222222222222222222222222222222111111111111111111111111111
1111111111222111111111111111111112221111122211111111111222222222222222222111111111111111111111111111
1111111111222111111111111111111112221111122211111111111222222222222222222111111111111111111111111111
1111111111222222111111111111111112221111122211111111111222222222222222222111111111111111111111111111
1111111111222222211222222222222112221111122211222222222222222222222222222222222222222221111111111111
1111111111122222211222222222222112221111122212222222222222222222222222222222222222222222111111111111
1111111111111122211222222222222112221111122212222222222222222222222222222222222222222222111111111111
1111111111111122211222222222222112221111122212221111111222222222222222222111111111111222111111111111
1111111111111122211222222222222222221111122212221111111222222222222222222111111111111222111111111111
1111111111111122211222222222222222221111122212221111111222222222222222222111111111111222111111111111
1111111111111122222222222222222222211111122212221111111111111111111111111111111111111222111111111111
1111111111111122222222222222222111111111122212221111111111111111111111111111111111111222111111111111
1111111111111112222222222222222111111111122212221111111111111111111111111111111111111222111111111111
1111111111111111111111111111111111111111122212221111111111111111111111111111111111111222111111111111
1111111111111111111111111111111111111111122212221111111111111111111111111111111111111222111111111111
1111111111111111111111111111111111111111122212221111111111111111111111111111111111111222111111111111
1111111111111111111111111111111111111111122212221111111111111111111111111111111111111222111111111111
1111111111111111111111111111111111111111222222222221111111111111111111111111111111111222111111111111
1111111111111111111111111111111111111111222222222221111111111111111111111111111111111222111111111111
1111111111111111111111111111111111111111111111111111111111111111111111111111111111111222111111111111
1111111111111111111111111111111111111111111111111111111111111111111111111111111111111222111111111111
