1111111111111111111111111111111111111111111111111111111111111111111111111111111111111111111111111111
1111111111111111111111111111111111111111111111111111111111111111111111111111111111111111111111111111
1111111111111111111111111111111111111111111111111111111111111111111111111111111111111111111111111111
1111111111111111111111111111111111111111111111111111111111111111111111111111111111111111111111111111
1111111111111111111111111111111111111111111111111111111122222222222222222111111111111111111111111111
1111111111111111111111111111111111111111111111111111111122222222222222222111111111111111111111111111
1111111111111111111111111111111111111111111111111111111122222222222222222111111111111111111111111111
1111111111111111111111111111111111111111111111111111222222222222222222222111111111111111111111111111
1111111111111111111111111111111111111111111111111112222222222222222222222111111111111111111111111111
1111111111111111111111111111111111111111111111111112222222222222222222222111111111111111111111111111
1111111111111111111111111111111111111111111111111112221122222222222222222111111111111111111111111111
1111111111111111111111111111111111111111111111111112221122222222222222222111111111111111111111111111
1111111111111111111111111111111111111111111111111112221122222222222222222111111111111111111111111111
1111111111111111111122222222222222222222211111111112221122222222222222222111111111111111111111111111
1111111111111111111222222222222222222222221111111112221122222222222222222111111111111111111111111111
1111111111111111111222222222222222222222221111111112221122222222222222222111111111111111111111111111
1111111111111111111222111111111111111112221111111112221122222222222222222111111111111111111111111111
1111111111111111111222111111111111111112221111111112221122222222222222222111111111111111111111111111
1111111111111111111222111111111111112222222222222112221111222111222111111111111111111111111111111111
1111111111111111111222111111111111112222222222222112221111222111222111111111111111111111111111111111
1111111111111111111222111111111222222222222222222222221111222211222222222222222222222211111111111111
1111111111111111111222111111112222222222222222222222221111222222222222222222222222222221111111111111
1111111111111111111222111111112222222222222222222222211111122222222222222222222222222221111111111111
1111111111111111111222111111112221112222222222222111111111111222211111111111111111112221111111111111
1111111111111111111222111111112221112222222222222111111111111122222211111111111111112221111111111111
1111111111111111111222111111112221112222222222222111111111111112222221111111111111112221111111111111
1111111111111111111222111111112221112222222222222111111111111111222221111111111111112221111111111111
1111111111111111111222111111112221111111111111111111111111111111112221111111111111112221111111111111
1111111111111111111222111111112221111111111111111111111111111111112221111111111111112221111111111111
1111111111111111111222111111112221111111111111111111111111111111112221111111111111112221111111111111
1111111111111111111222111111112221111111111122222222222222221111112221111111111111112221111111111111
1111111111111111111222111111112222222222222222222222222222221111112221111111111111112221111111111111
1111111111111111111222111111112222222222222211111111111112221111112221111111111111112221111111111111
1111111111111111111222111111111222222222222211111111111112221111112221111111111111112221111111111111
1111111111111111111222111111111111122222222211111111111112221111112221111111111111112221111111111111
1111111111111111111222111111111111122222222222221111111112221111112221111111111111112221111111111111
1111111111111111111222111111111111122222222222222111111112221111112221111111111111122222222211111111
1111111111111111111222111111111111122222222222222111111112221111112221111111111111122222222211111111
1111111111111111111222111111111111122222222211222111111112221111112221111111111111122222222211111111
1111111111111111111222111111111111122222222211222111111112221111112221111112222222222222222211111111
1111111111111111111222111111111111122222222211222111111112221111112221111122222222222222222222221111
1111111111111111111222111111111111122222222211222111111112221111112221111122222222222222222222222111
1111111111111111111222111111111111122222222211222111111112221111112221111122211111122222222222222111
1111111111111111111222111111111111122222222211222111111112221111112221111122211111122222222211222111
1111111111111111111222111111111111122222222211222111111112221111112221111122211111122222222211222111
1111111111111111111222111111111112221111111112222111111112221111222222222222222111112221111111222111
1111111111111111111222111111111112221111111122222111111112221111222222222222222111112221111111222111
1111111111111111111222111111111222221111111122221111111112221111222222222222222111222221111111222111
1111111111111111111222111111112222221111111222211111111112221111222222222222222112222221111111222111
1111111111111111111222111111112222211111111222111111111112221111222222222222222222222211111111222111
1111111111111111111222111111112221111111111222111111111112221111222222222222222222221111111111222111
1111111111111111111222111111112221111111111222111111111112221111222222222222222222211111111111222111
1111111111111111111222111111112221111111111222111111111112221111222222222222222111111111111111222111
1111111111111111111222111111112221111111111222111111111112221111222222222222222111111111111111222111
1111111111111111111222111111112221111111111222111111111112221111222222222222222111111111111111222111
1111111111111111111222111111112221111111111222111111111112221111222222222222222111111111111111222111
1111111111111111111222111111112221111111111222111111111112221111222222222222222111111111111111222111
1111111111111111111222111111112221111111111222111111111112221111222222222222222111111111111111222111
1111111111111111111222111111112221111111111222111111111112221111222222222222222111111111111111222111
1111111111111111111222111111112221111111111222111111111112221111222222222222222111111111111111222111
1111111111111111111222111111112221111111111222111111111112221111222222222222222111111111111111222111
1111111111111111111222111111112221111111111222111111111112221122211111222111111111111111111111222111
1111111111111111111222111111112221111111111222111111111112221122211111222111111111111111111111222111
1111111111111111111222111111112221111111111222111111111112221122211111222222222222222222211111222111
1111111111111111111222112222222222222222211222111111111112221122211111222222222222222222221111222111
1111111111111111111222112222222222222222211222111111111112221122211111122222222222222222221111222111
1111111111111111111222112222222222222222211222111111111112221122211111111111111111111112221111222111
1111111111111111111222112222222222222222211222111111111112221122211111111111111111111112221111222111
1111111111111111111222112222222222222222211222111111111112221122211111111111111111111112221111222111
1111111111111111111222112222222222222222211222111111111112221122211111111111111111111112221111222111
1111111111111111111222112222222222222222211222111111111112221122211111111111111111111112221111222111
1111111111111111111222112222222222222222211222111111111112221122211111111111111111111112221111222111
1111111111111111111222112222222222222222211222111111111112221122211111111111111111111112221111222111
1111111111111111111222112222222222222222211222111111111112221122211111111111111111111112221111222111
1111111111111111111222112222222222222222211222111111111112221122211111111111111111111112221111222111
1111111111111111111222112222222222222222211222111111111112221122211111111111111111111112221111222111
1111111111111111111222112222222222222222211222111111111112221122222222211111111111111112221111222111
1111111111111111111222211111111111111111112222111111111112221122222222211111111111111112221111222111
1111111111111111111222221111111111111111122222111111111112222222222222211111111111111112221122222111
1111111111111111111122222222222222222222222221111111111112222222222222222222211122222222222222222111
1111111111111111111112222222222222222222222211111111111111222222222222222222221122222222222222221111
1111111111111111111111111111111111111111111111111111111111111122222222222222221122222222222211111111
1111111111111111111111111111111111111111111111111111111111111122222222211112221122222222222211111111
1111111111111111111111111111111111111111111111111111111111111122222222211112221122222222222211111111
1111111111111111111111111111111111111111111111111111111111111122222222211112222222222222222211111111
1111111111111111111111111111111111111111111111111111111111111122222222211112222222222222222211111111
1111111111111111111111111111111111111111111111111111111111111122222222211111222222222222222211111111
1111111111111111111111111111111111111111111111111111111111111122222222211111111122222222222211111111
1111111111111111111111111111111111111111111111111111111111111122222222211111111122222222222211111111
1111111111111111111111111111111111111111111111111111111111111122222222211111111122222222222211111111
1111111111111111111111111111111111111111111111111111111111111122222222211111111122222222222211111111
1111111111111111111111111111111111111111111111111111111111111111111111111111111111222111111111111111
1111111111111111111111111111111111111111111111111111111111111111111111111111111111222111111111111111
1111111111111111111111111111111111111111111111111111111111111111111111111111111122222111111111111111
1111111111111111111111111111111111111111111111111111111111111111111111111111111222222111111111111111
1111111111111111111111111111111111111111111111111111111111111111111111111111111222221111111111111111
1111111111111111111111111111111111111111111111111111111111111111111111111111111222111111111111111111
1111111111111111111111111111111111111111111111111111111111111111111111111111111222111111111111111111
1111111111111111111111111111111111111111111111111111111111111111111111111111111222111111111111111111
1111111111111111111111111111111111111111111111111111111111111111111111111111111222111111111111111111
