1111111111111111111111111111111111111111111111111111111111111111111111111111111111111111111111111111
1111111111111111111111111111111111111111111111111111111111111111111111111111111111111111111111111111
1111111111111111111111111111111111111111111111111111111111111111111111111111111111111111111111111111
1111111111111111111222222222222222211111111111111111111111111111111111111111111111111111111111111111
1111111111111111111222222222222222211111111111111111111111111111111111111111111111111111111111111111
1111111111111111111222222222222222211111111111111111111111111111111111111111111111111111111111111111
1111111111111111111222222222222222211111111111111111111111111111111111111111111111111111111111111111
1111111111111111111222222222222222211111111111111111111111111111111111111111111111111111111111111111
1111111111111111111222222222222222211111111111111111111111111111111111111111111111111111111111111111
1111111111111111111222222222222222211111111111111111111111111111111111111111111111111111111111111111
1112222222222222222222222222222222211111111111111111111111111111111111111111111111111111111111111111
1122222222222222222222222222222222211111111111111111111111111111111111111111111111111111111111111111
1122222222222222222222222222222222222221111111111111111111111111111111111111111111111111111111111111
1122211111111111111222222222222222222222111111111111111111111111111111111111111111111111111111111111
1122211111111111111222222222222222222222111111111111111111111111111111111111111111111111111111111111
1122211111111111111222222222222222211222111111111111111111111111111111111111111111111111111111111111
1122211111111111111222222222222222211222111111111111111111111111111111111111111111111111111111111111
1122211111111111111222222222222222211222111111111111111111111111111111111111111111111111111111111111
1122211111111111111222222222222222211222111111111111111111111111111111111111111111111111111111111111
1122211111111111111111111111222111111222111111111111111111111111111111111111111111111111111111111111
1122211111111111111111111111222111111222111111111111111111111111111111111111111111111111111111111111
1122211122222222222222222222222111111222111111111111111111111111111111111111111111111111111111111111
1122211222222222222222222222222111111222111111111111111111111111111111111111111111111111111111111111
1122211222222222222222222222221111111222111111111111111111111111111111111111111111111111111111111111
1122211222111111111111111111111111111222111111111111111111111111112222222322222221111111111111111111
1122211222111111111111111111111111111222111111111111111111111111112222222222222221111111111111111111
1122211222111111111111111111111111111222111111111111111111111111112222222222222221111111111111111111
1122211222111111111111111111111111111222111111111111111111111111112222222222222221111111111111111111
1122211222111111111111111111111111111222111111111112222222222222222222222222222221111111111111111111
1122211222222222221111111111111111111322111111111122222222222222222222222222222222222222111111111111
1122211222222222221111111111111111111222111111111122222222222222222222222222222222222222211111111111
1122211222222222221111111111111111111222111111111122211111111111112222222222222222222222211111111111
1122211222222222221111111111111111111222111111111122211111111111112222222222222221111122211111111111
1122211222222222221111111111111111111222111111111122211111111111112222222222222221111122211111111111
1122211232222222221111111111111111111222111111111122211111111111112222222222222221111122211222222211
1122211222222222221111111111111111111222111111111122211111111111112222222222222221111122211222222211
1122211222222222221111111111111111111222111111111122211111111111112222222222222221111122211222222211
1122211222222222221111111111111111111222111111111122211111111111112222222222222221111122211222222211
1122211222222222221111111111111111111222111111111122211111111111112222222222222221111122222222222211
1122211222222222221111111111111111111222111111111122211111111111111111111111111111111122222222222211
1122211222222222221111111111111111111222111111111122211111111111111111111111111111111112222222222211
1122212211111111111111112222222222222222222222221122211111111111111111111111111111111111111222222211
1122212211111111111111122222222222222222222222221122211111111111111111111111111111111111111222222211
1122212221111111111111122222222222222222222222221122211111111111111111111111111111111111111222222211
1122212222111111111111122211111111222222222222321122211111111111111111111111111111111111111222222211
1122212222111111111111122211111111222222222222221122211111111111111111111111111111111111111222222211
1122221222112222222221122211111111222222222222221122211111111111111111111111111111111111111222222211
1112221222112222222221122211111111222222222222221122211111111111111111111111111111111111111222222211
1112221222112222222221122211111111222222222222222222211111111111111111111111111111111111111122211111
1112221222113222222221122211111111222222222222222222211111111111111111111111111111111111111122211111
1112221222112222222221122211111111222222222222222222111111111111111111111111111111111111111122211111
1112221222222222222222222211111111222222222222221111111111111111111111111111111111111111111222211111
1112222222222222222222222211111111222222222222221111111111111111111111111111111111111111111222111111
1112222222222222222222222111111111222222222222221111111111111111111111111111111111111111111222111111
1111222211112222222221111111111111222222222222221111111111111111111111111111111111111111111222111111
1111122221112222222221111111111111222222222222221111111111111111111111111111111111111111111222111111
1111112222222222222221111111111111222222222222221111111111111111111111111111111111111111111222111111
1111111222222222222221111111111111222222222222221111111111111111111111111111111111111111111222111111
1111111122222222222221111111111111122211122211111111111111111111111111111111111111111111111222111111
1111111111112222232221111111111111122211122211111111111111111111111111111111111111111111111222111111
1111111111112221111111111111111111222211122222111111111111111111111111111111111111111111111222111111
1111111111112221111111111111111112222211122222211111111111111111111111111111111111111111111222111111
1111111111112222222222222222221112222111112222211111111111111111111111111111111111111111111222111111
1111111111112222222222222222222112221111111122211111111111111111111111111111111111111111111223111111
1111111111111222222222222222222112221111111122211111111111111111111111111111111111111111111222111111
1111111111111111111111111111222112221111111122211111111111111111111111111111111111111111111222111111
1111111111111111111111111111222112221111111122211111111111111111111111111111111111111111111222111111
1111111111111111111111111111222112221111111122211111111111111111111111111111111111111111111222111111
1111111111111111111111111111222112221111111122211111111111111111111111111111111111111111111222111111
1111111111111111111111111111222112221111111122211111111111111111111111111111111111111111111222111111
1111111111111111111111111111222112221111111122211111111111111111111111111111111111111111111222111111
1111111111111111111111111111222112221111111122211111111111111111111111111111111111111111111222111111
1111111111111111111111111111222112221111111122211111111111111111111111111111111111111111111222111111
1111111111111111111111111111222112221111111122211111111111111111111111111111111111111111111222111111
1111111111111111111111111111222122221111111122211111111111111111111111111111111111111111111222111111
1111111111111111111111111111222222221111111122211111111111111111111111111111111111111111111222111111
1111111111111112222222222222222222211111111122211111111111111111111111111111111111111111111222111111
1111111111111112222222222222222111111111111122211111111111111111111111111111111111111111111222111111
1111111111111112222222222222223111111111111122211111111111111111111111111111111111111111111222111111
1111111111111112222222222222222111111111111122211111111111111111111111111111111111111111111222111111
1111111111111112222223222222222222222221111122211111111111111111111111111111111111111111111222111111
1111111111111112222222222222222222222222111122211111111111111111111111111111111111111111111222111111
1111111111111112222222222222222222222222111122211111111111111111111111111111111111111111111222111111
1111111111111112222222222222222111111222111122211111111111111111111111111111111111111111111222111111
1111111111111112222222222222222111111222111122211111111111111111111111111111111111111111111222111111
1111111111111112222222222222222111111222111122211111111111111111111111111111111111111111111222111111
1111111111111112222222222222222111111222111122211111111111111111111111111111111111111111111222111111
1111111111111112222222222222222111111222111122211111111111111111111111111111111111111111111222111111
1111111111111112223222222222222111111222111122211111111111111111111111111111111111111111111222111111
1111111111111112222222222222222111111222111122211111111111111111111111111111111111111111111222111111
1111111111111111111111111111111111111222111122211111111111111111111111111111111111111111111222111111
1111111111111111111111111111111111111222111122211111111111111111111111111111111111111111111222111111
1111111111111111111111111111111111111222111122211111111111111111111111111111111111111111111222111111
1111111111111111111111111111111111111222111122211111111111111111111111111111111111111111111222111111
1111111111111111111111111111111111111222111122211111111111111111111111111111111111111111111222111111
1111111111111111111111111111111111111222222222222222222211111111111111111111111111111111111222111111
1111111111111111111111111111111111111222222222222222222211111111111111111111111111111111111222111111
1111111111111111111111111111111111111122222222222222222211111111111111111111111111111111111222111111
1111111111111111111111111111111111111111111111111111111111111111111111111111111111111111111222111111
1111111111111111111111111111111111111111111111111111111111111111111111111111111111111111111222111111
