1111111111111111111111111111111111111111
1222111111111111111111222222222122211111
1222122222222222222221222222222122211111
1222122222222222222221222222222122211111
1222122222222222222221222222222122211111
1222122222222222222221222222222122211111
1222122222222222222221222222222122211111
1222122222222222222221222222222122211111
1222222222222222222222222222222122211111
1222222222222222222222222222222122211111
1222222222222222222222222222222122211111
1222111111111111111111222222222122211111
1222111111111111111111222222222122211111
1222111111111111111111222222222222211111
1222111111111111111111222222222222211111
1222111111111111111111222222222222211111
1222111111111111111111222222222122211111
1222111111111111111111222222222122211111
1222111111111111111111111111111122211111
1222222222222222222222222222222222222211
1222222222222222222222222222222222222211
1222222222222222222222222222222222222211
1222111111111111111111111111111112221111
1222111111111111111111111222222222222211
1222111111111111111111111222222222222211
1222111111111111111111111222222222222211
1222111111111111111111111222222222222211
1222111111111111111111111222222222222211
1222111111111111111111111222222222222211
1222111111111111111111111222222222222211
1222111111111111111111111222222222222211
1222111111111111111111111222222222222211
1222111111111111111111111222222222222211
1222111111111111111111111222222222222211
1222111111111111111111111111111111122211
2222222222222222222222222222222222222211
2222222222222222222222222222222222222211
2222222222222222222222222222222222222211
1111111111111111111111111111111111111111
1111111111111111111111111111111111111111